###################
#.................#
#........@........#
#.................#
#....#########....#
#.................#
#####.........#####
#.................#
#.................#
#.......###.......#
#.................#
#........!........#
#.................#
#.................#
#.................#
#.................#
#.................#
###################