###################
#@................#
##########........#
#.................#
#.......###########
#.................#
###########.......#
#.............!...#
#.................#
###################
#.................#
#....##.....##....#
#....##.....##....#
#.................#
#.....#.....#.....#
#......#####......#
#.................#
###################