###################
#.................#
#.##.#...@...#.##.#
#....#.......#....#
##..###########..##
#.................#
########...########
#.................#
#.................#
#.......###.......#
#.......#!#.......#
#.................#
#.................#
#.................#
#.................#
#.................#
#.................#
###################