###################
#.................#
#.................#
#....#.......#....#
#.....##.#.##.....#
#......#...#......#
#..###.#...#.###..#
#......#...#......#
#......#.@.#......#
#......#####......#
#......##!##......#
#......##.##......#
#......##.##......#
#.................#
#.................#
#.................#
#.................#
###################