###################
#.................#
#........@........#
#.................#
#....#########....#
#.................#
#####.........#####
#.................#
#.................#
#.......###.......#
#........#........#
#.................#
#########.#########
#.........#.......#
#......####.......#
#.................#
#................!#
###################